Account number,Date,Memo/Description,Source Code (payment type),TP ref,TP part,TP code,OP ref,OP part,OP code,OP name,OP Bank Account Number,Amount (credit),Amount (debit),Amount,Balance
38-9018-0879026-00,11-02-2020,TRANSFER FROM S R I MASSET-GLENCROSS - 02 ;Emergency,,,Emergency,,,,,S R I MASSET-GLENCROSS,38-9018-0879026-02,385.97,,385.97,447.28
38-9018-0879026-00,11-02-2020,TRANSFER FROM S R I MASSET-GLENCROSS - 02 ;Invest,,,Invest,,,,,S R I MASSET-GLENCROSS,38-9018-0879026-02,578.95,,578.95,1026.23
38-9018-0879026-00,11-02-2020,PAY SIMPLICITY KIWISAVER ;Kiwisaver,,,Kiwisaver,,58887889,Masset-Glenc,0,SIMPLICITY KIWISAVER,01-1839-0816624-00,,1043.00,-1043.00,-16.77
38-9018-0879026-00,11-02-2020,PAY Simplicity ;Masset-Glenc Growth SIMF014956,,SIMF014956,Masset-Glenc,Growth,SIMF014956,Masset-Glenc,Growth,Simplicity,01-1839-0816624-07,,486.55,-486.55,-503.32
38-9018-0879026-00,24-02-2020,TRANSFER FROM S R I MASSET-GLENCROSS - 02 ;Emergency Invest,,,Emergency,Invest,,,,S R I MASSET-GLENCROSS,38-9018-0879026-02,286.78,,286.78,-216.54
38-9018-0879026-00,28-02-2020,AP#13234047 FROM S R I MASSET-GLENCROSS ;Transfer from S R I MASSET-GLENCROSS - 03,,,LOAN PAYMT,,,,,S R I MASSET-GLENCROSS,38-9018-0879026-03,82.88,,82.88,-133.66
38-9018-0879026-00,29-02-2020,LOAN INTEREST ;,,,,,,,,,,,1.06,-1.06,-134.72
38-9018-0879026-00,18-03-2020,TRANSFER FROM S R I MASSET-GLENCROSS - 02 ;,,,,,,,,S R I MASSET-GLENCROSS,38-9018-0879026-02,320.00,,320.00,185.28
38-9018-0879026-00,31-03-2020,LOAN INTEREST ;,,,,,,,,,,,0.34,-0.34,184.94
